
WE ./assets/west.xpm
SO    ./assets/south.xpm
NO   ./assets/north.xpm	

C	                  240, 155, 34  
F    30 ,1 30, 30      
EA         					./assets/east.xpm



		
1111111111111111111111111
1000000000000000000000001
1001111000111000000000001
1000001000001000000000001
1E00001000001000000000001
1001111000000000000000001
1000000000000000000000001
1000100010000000000000001
1111111111001000000000001
1111111111000000000000001
1111111111001000000000001
1111111111000000000000001
1100000000000000000000001
1000000000000000000000001
1111111111111111111111111
1000000000000000000000001
1000000000000000000000001
1000000000000000000000001
1001000100010000000000001
1000000000000000000000001
1000000000000000000000001
1000000000000000000000001
1111111111111111111111111