NO img/MARBFAC2.xpm
WE img/SKULWALL.xpm
SO img/MARBFACE.xpm
EA img/SKULWAL3.xpm

F 0,32,0
C 120,0,16

        1111111111111111111111111 
        1000000000110000001100001 
        1111000001110000S11100001     
           1001000000000000000011
111111111111000001110000100000001
100000000011000001110111110111111
11110111111111011100000010001
11110111111111011101010010001
11000000110101011100000000001
10000000000000001100000010001
10000000000000001101010011111
11000001110101011111011100001
11110111 1110101 101111011111
11111111 1111111 111111111111
