NO textures/test1.xpm



            SO textures/test2.xpm

    WE textures/test3.xpm
EA textures/test4.xpm

F 0,0,255

C 225, 0, 0

01111111111111111111111111110
10000000000000000000000100001
10000000000000000000000100001
1000000000000000001100100001
10000000000000000000000000001
10000000011000000000100000001
10000000100000000000000000001
100010000000000000000N0000001
10001110000000000100000000001
01111111111111111111111111110