NO textures/wood1.xpm



            SO textures/wood2.xpm

    WE textures/tijolos.xpm
EA textures/wall_rock.xpm

C 51, 51, 255
F 102,255,255


11111111111111111111111111111
11000000000000000000000010001
10000000000000000000000100001
10000000000000000011100100001
10000000000000000000D00000001
10000000011000000000100000001
10000000100000000000000000001
100010000000000000000W0000001
10001110000000000100000000001
11111111111111111111111111111
