NO textures/test1.xpm



            SO textures/test2.xpm

    WE textures/test3.xpm
EA textures/test4.xpm

F 0,0,255

C 225, 0, 0

11111111111111111111111111111 
10000000000000000000000000001
10000000000000000000000000001
10000000000000000000000000001
10000000000000000000000000001
10000000000000000000000000001
10000000000000000000000000001
1000000000000000000E000000001
10000000000000000000000000001
11111111111111111111111111111
