NO textures/test1.xpm



            SO textures/test2.xpm

    WE textures/test3.xpm
EA textures/test4.xpm

F 0,0,255

C 225, 0, 0

11111111111111111111111111111 
10000000000000000000000000001
10000000000000000000000000001
10000000000000000010100000001
10000000000000000000000000001
10000000011000000000000000001
10000000100000000000000000001
10001000000000000000N00000001
10001110000000000100000000001
11111111111111111111111111111
