NO textures/test1.xpm



            SO textures/test2.xpm

    WE textures/test3.xpm
EA textures/test4.xpm

F 0,0,0

C 225, 255, 255

        11111 11111111 11111111111
        10101 1000001E 10000000001
        10001 10000000100000000001
1111 11110000100000000000000001111
1001 10000000000000000000000001
1001 10000000000000000000000001
1000100000000000000000000000001
1100000000000000000000000000001
1111111111111111111111111111111