NO textures/test1.xpm



            SO textures/test2.xpm

    WE textures/test3.xpm
EA textures/test4.xpm

F 0,0,0

C 225, 255, 255

        1111111111111111111111111
        0000000000110000000000001
        1011000001110000000000001
        1001000000000000000000001
111111111011000001110000000000000
100000000011000001110111111111111
11110111111111011100000010001
11110111111111011101010010001
11000000110101011100000010001
11101100000000001100000010001
1    100000000001101010010001
1111110111010101111101111S001
11110111 1110101 101111010001
11111111 1111111 111111111111

// 0 seguido de espaco = ERRADO
// 0 seguido de \n ERRADO
// 0 seguido de '\0' ERRADO
// ESPACO seguido de 0 ERRADO