NO textures/wolfstein/eagle.xpm



            SO textures/wolfstein/eagle.xpm

    WE textures/wolfstein/eagle.xpm
EA textures/wolfstein/eagle.xpm

F 0,0,0

C 225, 255, 255

        11111 11111111111111111111
        10101 10000000000000000001
        10001 10000000000000000001
1111 11110000100000000000000001111
1001 10000000000000000000000001
1001 10000000000000000000000001
1S00100000000000000011110000001
1100000000000000000 10000000001
1111111111111111111 11111111111