NO textures/test1.xpm



            SO textures/test2.xpm

    WE textures/test3.xpm
EA textures/test4.xpm

F 0,0,0

C 225, 255, 255

        10111  1111111111111111111
        10101  1001100000000000001
1111111110111111111000000000101111
1010101110010000000000000000001001
1011111110110000011100000000000101
1000000000110000011101111011111111
11110111111111111100000010001
11110111111111 11101010010001
11000000110101111100000010101
10000000100100001100000011 11
10000001010000001101010010101
11000001110101011111011110111
1E110111 1110101 10111 110101
11111111 1111111 111111111111
